1110000000000000000000000000011
1110000000000000000000000000011
1110404000000004000000004000411
1114037004000400040004000000011
1150340400300000400200404040411
111320002300232020111000020k011
1111112011111911111110001111111
1111111111111111111113731111111
9999999999999999999999999999999