1110004000004000400000004000400011
1110000400000000000400000004040k11
1110040400400404000000040000011111
105400400422004004000400000431111
1110040011111404000400000373011
1110200111111200000000003200011
1111111111111111088880071199911
1111111111111111102220111111111
1111111111111111111111111111111