1110004000004000400000004000400011
1110000400000000000400000004040k11
1110040400400404000000040000011111
1054004004220040040004000004311111
1110040011111404000400000373011111
1110200111111200000000003200011111
1111111111111111088880071199911111
1111111111111111102220111111111111
1111111111111111111111111111111111
9999999999999999999999999999999999