111000400000400040000000400001000001
1110000400000000000400000000010000k1
111004000040040000000004000001031111
105000040404004014040400400041301111
111484800310407010040002000401031111
111222203012222714000201100001301111
111111111011111110011100001122231111
111111111002020200311100031111111111
111111111111111111111137371111111111
999999999999999999991199911199999999
