111000400000400040000000400001000001
1110000400000000000400000000010000k1
111004000040040000000004000001031111
10000004040400401404040040004130111
1114848003104070100400020004010311
1112222030122227140502011000013011
1111111110111111100111000011222311
1111111110020202003111000311111111
1111111111111111111111373711111111
0000000000000000000011999111000000