11041110000000001100000000000000004111040011111
110002100020202020000000000000000400k0040001111
11501113011111111110404040404040401111111301111
11300210300000000118000004000000002030004031111
11001113020200000110804040404000111110040301111
11700211111111000118000404000033004040004031111
11001110000000330110801070701300040404040301111
11000200000000023110011222281120001111100231111
11111111883888111111111111111111001110001111111
11111111999999111111111111111111700200711111111
11111111111111111111111111111111111111111111111
99999999999999999999999999999999999999999999999