11041110000000001100000000000000004111040011111
110002100020202020000000000000000400k0040001111
11501113011111111110404040404040401111111301111
11300210300000000118000004000000002030004031111
11001113020200000110804040404000111110040301111
11700211111111000118000404000033004040004031111
11001110000000330110801070701300040404040301111
11000200000000023110011222281120001111100231111
1111111188388811111111111111111100111000111111
1111111199999911111111111111111170020071111111
0000001111111111111111111111111111111111111111